Александр	Елена
Сергей	Татьяна
Владимир	Ольга
Андрей	Наталья
Алексей	Ирина
Дмитрий	Светлана
Николай	Анна
Евгений	Екатерина
Михаил	Людмила
Юрий	Мария
Виктор	Галина
Иван	Юлия
Игорь	Анастасия
Анатолий	Валентина
Максим	Надежда
Олег	Марина
Павел	Нина
Валерий	Любовь
Константин	Александра
Вячеслав	Вера
Василий	Лариса
Денис	Оксана
Антон	Тамара
Илья	Дарья
Виталий	Евгения
Роман	Ксения
Никита	Лидия
Леонид	Наталия
Владислав	Виктория
Геннадий	Елизавета
